,BasePair,true_precision,true_recall,true_f1,false_precision,false_recall,false_f1,false_support,true_support,tn,fp,fn,tp
0,AA,0.8053097345132744,0.978494623655914,0.883495145631068,0.9995893223819302,0.9955010224948875,0.9975409836065574,4890,93,4868,22,2,91
1,CG,0.8660998937300743,0.9890776699029126,0.9235127478753541,0.9991880187657886,0.9887510043746094,0.9939421135292799,11201,824,11075,126,9,815
2,AU,0.8542056074766355,0.9956427015250545,0.9195171026156942,0.9997054925636872,0.9886413280908694,0.9941426270317762,6867,459,6789,78,2,457
3,AC,0.24598930481283424,0.968421052631579,0.3923240938166312,0.9996840109542869,0.9711449913025683,0.9852078683759796,9773,95,9491,282,3,92
4,GU,0.7489539748953975,0.9781420765027322,0.8483412322274881,0.9995167331158632,0.9927997119884795,0.9961468994581577,8333,183,8273,60,4,179
5,UU,0.8709677419354839,1.0,0.9310344827586207,1.0,0.9984101748807631,0.9992044550517105,2516,27,2512,4,0,27
6,GG,0.5934065934065934,0.9152542372881356,0.7200000000000001,0.9992525041112273,0.9944948668352923,0.9968680089485459,6721,59,6684,37,5,54
7,CC,0.6666666666666666,0.92,0.7731092436974789,0.9991113085980893,0.9949115044247787,0.997006983704689,4520,50,4497,23,4,46
8,AG,0.41964285714285715,0.9757785467128027,0.5868886576482831,0.9993756689261506,0.9663648124191462,0.9825930635331258,11595,289,11205,390,7,282
9,CU,0.5555555555555556,0.8181818181818182,0.661764705882353,0.9985311398354877,0.9947322212467077,0.9966280604017006,6834,55,6798,36,10,45
